5 5 5 5 5 5 5 5 5 5 5 5 5 5 5 5 5
5 5 4 4 0 0 0 0 0 0 0 0 0 0 0 5 5
5 5 4 1 0 1 0 1 0 1 0 1 0 1 0 5 5
5 5 4 4 4 4 0 0 0 0 0 0 0 0 0 5 5
5 5 4 1 0 1 0 1 0 1 0 1 0 1 0 5 5
5 5 0 0 0 0 0 0 4 0 0 0 0 0 0 5 5
5 5 0 1 0 1 0 1 4 1 0 1 0 1 0 5 5
5 5 0 0 0 0 0 0 4 0 0 0 0 0 0 5 5
5 5 0 1 0 1 0 1 4 1 0 1 0 1 0 5 5
5 5 0 0 0 0 0 0 0 0 0 0 0 0 0 5 5
5 5 0 1 0 1 0 1 0 1 0 1 0 1 0 5 5
5 5 0 0 0 0 0 0 0 0 0 0 0 0 0 5 5
5 5 5 5 5 5 5 5 5 5 5 5 5 5 5 5 5